11211121112111222-
21212121212121222-
21212121212121222-
21212121212121222-
21112111212121222-
22222222211121122