0000000000000000000022222222222222-
0000000000000000000000000000000222-
0000000000000000000000002222222222-
0000000000000000022222222222222222-
0000000000000000000000222222222222-
0000000000000000000002222222222222-
2222222222222222222222222222222222-
2222222222222222222222222222222222-
2222222222222222222222222222222222-
2222222222222222222222222222222222-
2222222222222222222222222222222222-
2222222222222222222222222222222222-
2222222222222222222222222222222222-
2222222222222222222222222222222222-
2222222222222222222222222222222222-
2222222222222222222222222222222222-
2222222222222222222222222222222222-
2222222222222222222222222222222222-
2222222222222222222222222222222222-
2222222222222222222222222222222222-
2222222222222222222222222222222222-
2222222222222222222222222222222222-
2222222222222222222222222222222222-
2222222222222222222222222222222222-
2222222222222222222222222222222222-
2222222222222222222222222222222222-
2222222222222222222222222222222222