1121112111211122222222222222222222-
2211212121212122222222222222222222-
2121212121212122222222222222222222-
2121212121212122222222222222222222-
2111211121212122222222222222222222-
2222222221112112222222222222222222-
2222222222222222222222222222222222-
2222222222222222222222222222222222-
2222222222222222222222222222222222-
2222222222222222222222222222222222-
2222222222222222222222222222222222-
2222222222222222222222222222222222-
2222222222222222222222222222222222-
2222222222222222222222222222222222-
2222222222222222222222222222222222-
2222222222222222222222222222222222-
2222222222222222222222222222222222-
2222222222222222222222222222222222-
2222222222222222222222222222222222-
2222222222222222222222222222222222-
2222222222222222222222222222222222-
2222222222222222222222222222222222-
2222222222222222222222222222222222-
2222222222222222222222222222222222-
2222222222222222222222222222222222-
2222222222222222222222222222222222-
2222222222222222222222222222222222